4
   777777777
   727872787
   787878787
777787878787777
7be888888888be7
777787878787777
   787878787
   787478747
   777777777
