3
777777777
788888887
787787787
787787787
788888887
787787787
787787787
78e748887
777777777
